..............................
.############################.
.#..........................#.
.#..........................#.
.#..........................#.
.############...####...######.
.#..........#...#...........#.
.#..........#...#...........#.
.#..............#...........#.
.############...#############.
.#..........#...#...........#.
.#..........................#.
.#..........#...#...........#.
.############...#############.
.#..............#...........#.
.#..........................#.
.#..............#...........#.
.#..............#...........#.
.############################.
..............................
