.............................
.###########################.
.#.........................#.
.#.........................#.
.#.........................#.
.############...####...#####.
.#..........#...#..........#.
.#..............#..........#.
.#..........#...#..........#.
.############...############.
.#..........#...#..........#.
.#.........................#.
.#..........#...#..........#.
.############...############.
.#..............#..........#.
.#.........................#.
.#..............#..........#.
.#..............#..........#.
.###########################.
.............................
