                              
 ############################ 
 #                          # 
 #                          # 
 #                          # 
 ############   ####   ###### 
 #          #   #           # 
 #          #   #           # 
 #              #           # 
 ############   ############# 
 #          #   #           # 
 #                          # 
 #          #   #           # 
 ############   ############# 
 #              #           # 
 #                          # 
 #              #           # 
 ############################ 
                              
                              
