                              
          ~~~~~~~~            
         ~~~~~~~~~~~~         
      ~~~~~~~~~~~~~~~~        
    ~~~~~~~~~~~~~~~~~~~~      
  ~~~~~~~~~^~~~~~~~~~^~~~~    
   ~~~~~~~^^^~~~~~~~^~~~~~~   
    ~~~~~~~^~~~~~~~~~~~~~~    
  ~~~~~~~~~~~~~~~~~~~~~~~~~   
  ~~~~~~~~~~~~~~~~~~~~~~~~~   
   ~~~~~~~~~~~~~^^~~~~~~~~    
   ~~~~~~~~~~~~~^^~~~~~~~~    
   ~~~~~~~~~~~~~~^^~~~~~~~~   
    ~~~~~~~~~~~~~~^^~~~~~~~~  
    ~~^^~~~~~~~~~~~~~~~~~~    
    ~~~~~~~~~~~~~~~~~~~~~     
      ~~~~~~~~~~~~~~~~~~~~~   
     ~~~~~~~~~~~~^^^~~~~~~~~  
    ~~~^~~~~~~~^^^~~~~~~~~    
    ~~~~^~~~~~~~~~~~~~~~~     
      ~~^^~~~~~~~~~~~~~       
       ~~~~~~~~~~~~~          
          ~~~~~~~~            
                              
